1111111111111111111111
1P000000000000C1000001
1000111111100010000001
1C0010000E000000000001
1111001111111001000001
1C00000000000001000001
1000000C00000001111001
11C110000010000000C111
1111111111111111111111