1111111111111
1P000000000C1
1000111111101
1C0010000E001
1111001111111
1C00000000001
1111111111111