111111111
10C000011
100C10111
11P0P0C11
1010C00E1
111111111